	--= A =--
access = πρόσβαση
administer = διαχείριση
administrator = διαχειριστής
aggregate = συλλογή, συνάθροιση
approved = εγκεκριμένο
	--= B =--
block = μπλοκ
blog entry = ιστολόγημα
blog = ιστολόγιο
box = πλαίσιο
	--= C =--
categorize = κατάταξη σε κατηγορία
collapsed = συμπτυγμένος
configuration = διευθέτηση, ρύθμιση
contact = επικοινωνία
customization = προσαρμογή
	--= D =--
default = προεπιλεγμένο
	--= E =--
e-mail = ηλεκτρονικό ταχυδρομείο, e-mail
edit = τροποποίηση
expanded = ξεδιπλωμένο
	--= F =--
format = μορφότυπος
form = φόρμα
forum = φόρουμ
	--= G =--
	--= H =--
handbook = εγχειρίδιο
hierarchy = ιεραρχία
	--= I =--
item = αντικείμενο, στοιχείο
	--= J =--
	--= K =--
	--= L =--
link = σύνδεσμος, παραπομπή
	--= M =--
module = μονάδα
	--= N =--
news = ειδήσεις, νέα
	--= O =--
overview = επισκόπηση, περίληψη
	--= P =--
permission = άδεια
post = δημοσίευση, καταχώριση
preview = προεπισκόπηση
profile = προφίλ
	--= Q =--
	--= R =--
region = περιοχή
	--= S =--
server = διακομιστής
settings = ρυθμίσεις
sidebar = πλευρική/παράπλευρη μπάρα
site = ιστότοπος
story = ιστόρημα
	--= T =--
tab = καρτέλα
tag = σήμανση, ετικέτα
theme = θεματική παραλλαγή
throttle = απόπνιξη
topic = θέμα
	--= U =--
	--= V =--
	--= W =--
widget = γραφικό συστατικό
	--= X =--
	--= Y =--
	--= Z =--
