	--= A =--
access = πρόσβαση
administer = διαχείριση
administrator = διαχειριστής
aggregate = συλλογή, συνάθροιση
approved = εγκεκριμένο
	--= B =--
block = μπλοκ
blog entry = ιστολόγημα
blog = ιστολόγιο
box = πλαίσιο
	--= C =--
categorize = κατάταξη σε κατηγορία
checkbox = πλαίσιο/κουτί επιλογής
collapsed = συμπτυγμένος
configuration = διευθέτηση, ρύθμιση
contact = επικοινωνία
content = ύλη, περιεχόμενο
customization = προσαρμογή
custom = προσαρμοσμένος
	--= D =--
default = προεπιλεγμένο
directory = κατάλογος
download = λήψη, λαμβάνω
drag and drop = σύρε και άσε
	--= E =--
edit = τροποποίηση
e-mail = ηλεκτρονικό ταχυδρομείο, e-mail
error = σφάλμα
expanded = ξεδιπλωμένο
	--= F =--
format = μορφότυπος
form = φόρμα
forum = φόρουμ
	--= G =--
	--= H =--
handbook = εγχειρίδιο
hierarchy = ιεραρχία
human-readable = ανθρωπίνως αναγνώσιμο
	--= I =--
item = αντικείμενο, στοιχείο
	--= J =--
	--= K =--
	--= L =--
link = σύνδεσμος, παραπομπή
	--= M =--
machine-readable=μηχανικώς αναγνώσιμος
module = μονάδα
	--= N =--
news = ειδήσεις, νέα
	--= O =--
overload = υπερφόρτωση, υπέρβαση
overview = επισκόπηση, περίληψη
order - ordering = κατάταξη
	--= P =--
password = συνθηματικό
permission = άδεια
plugin = πρόσθετο
post = δημοσίευση, καταχώριση
preview = προεπισκόπηση
profile = προφίλ
primary = πρωτεύων
	--= Q =--
	--= R =--
region = περιοχή
revision = αναθεώρηση
RSS feed = ροή RSS
	--= S =--
server = διακομιστής
settings = ρυθμίσεις
sidebar = πλευρική/παράπλευρη ζώνη
site = ιστοτόπος
story = ιστόρημα
	--= T =--
tab = καρτέλα
tag = σήμανση, ετικέτα
teaser = περίληψη (;)
term = όρος
theme = θεματική παραλλαγή, μοτίβο
throttle = απόπνιξη
topic = θέμα
	--= U =--
underscore = χαρακτήρας υπογράμμισης
upload = αποστολή, αποστέλλω
undo = αντιστρέφω, αναιρώ
	--= V =--
view = προβολή
vocabulary = λεξιλόγιο
	--= W =--
webpage = ιστοσελίδα
website = ιστοχώρος
widget = γραφικό συστατικό
	--= X =--
	--= Y =--
	--= Z =--
